---#--###----
-#---#----##- 
####-#-#-#-## 
---#---#-#--@ 
-#-####---##- 
-#------#---- 
-############
-------------